NO textures/mossy.xpm
SO textures/purple_stone.xpm
WE textures/red_brick.xpm
EA textures/wood.xpm

F 164,169,20
C 153,204,255


1111
10S1
1001
1111


1111
1001
1001
1111
