F 76,76,76
C 99,99,99

NO textures/mossy.xpm
SO textures/purple_stone.xpm
WE textures/red_brick.xpm
EA textures/wood.xpm

111111111111
1         11
1       0001
1000000 0011
10S000000001
111111111111
11         1
111111111111

