NO textures/mossy.xpm
SO textures/purple_stone.xpm
WE textures/red_brick.xpm
EA textures/wood.xpm

F                   64, 122                  , 20
C 153,204,255


1111 
1001
10N1
1111
