NO textures/mossy.xpm
SO textures/purple_stone.xpm
WE textures/red_brick.xpm
EA textures/wood.xpm

C 10,10,10
F 255,255,255

111111111111111111111111111111
111111000111111111111000111111
111110000011111111110000011111
111100000001111111100000001111
111000000000111111000010000111
110000000000011110000111000011
100001111100001100001111100001
110000111000011110000111000011
111000010000110011000010000111
111100000001100001100000001111
111110000011000000110000011111
111111000110000000011000111111
11111111110000N000011111111111
111111000110000000011000111111
111110000011000000110000011111
111100000001100001100000001111
111000010000110011000010000111
110000111000011110000111000011
100001111100001100001111100001
110000111000011110000111000011
111000010000111111000010000111
111100000001111111100000001111
111110000011111111110000011111
111111000111111111111000111111
111111111111111111111111111111

