F 76,76,76
C 99,99,99

NO textures/mossy.xpm
SO textures/purple_stone.xpm
WE textures/red_brick.xpm
EA textures/wood.xpm

111111111111
1       1111          111111111111111
111111110001            1100000001111
100000010011        1111110000001111111
100000000001         1111100E0000111
111110111111          111100000011111
11   1     1          11111111111111
111
1
1
1
1                                      1
1
1
1