NO textures/mossy.xpm
SO textures/purple_stone.xpm
WE textures/red_brick.xpm
EA textures/wood.xpm

F 220,100,0
C 125,30,90

        1111111111111111111111111
        1000000000110000000000001
        1011000001110000000000001
        1001000000000000000000001
111111111011000001110000000000001
1000000000110000011101111111111111111111111111111111111111111111111
1111011111111101110000001000100000000000000000000000000000111000001
1111011111111101110101001000100000000011111111000000100000000000001
1100000011010101110000001000000000000000000000000100100000000000001
1000000000000000000000001000111111111111111111110100000000000000001
10000000000000001101010010001                  11111111111111111111
110000011101010111110111100111
11110111 1110101 101111010N01
11111111 1111111 111111111111
