NO textures/mossy.xpm
SO textures/purple_stone.xpm
WE textures/red_brick.xpm
EA textures/wood.xpm

F 18,53,25
C 153,204,255
    
    1111
    1S111
    10001111111111111
    11100000000000001
    11111111111111111
