NO textures/mossy.xpm
SO textures/purple_stone.xpm
WE textures/red_brick.xpm
EA textures/wood.xpm

F 18,53,25
C 153,204,255

111111111111
1         11
1          1
111111111111
10S000000001
110111111111
1          1
11 111111111
 111
